25
51
|||||||||||||||||||||||||||||||||||||||||||||||||||
|...|.......|...#####.......|.........|.......|...|
|.|.|||.|||.|||||||||||.|||.|.|||||||.|||.|||||...|
|.|...|.|.|...........|.|.|...|.....|.....|...|...|
|.|||.|.|.|||###|||||.|.|.|||||.|||||||||||||.|||.|
|.|.|...|...........|.|.|.##..|.......|.......|.|.|
|.|.|||||.|||.|||||||.|.|.|.|||.|||.|||.|||.|.|.|.|
|.|.........|.|.......|.|.|.....|...|...|.|.|...|.|
|.|.|||||||.|||.|||||||.|||||.|||.|||.|||.|.|||.|.|
|.|.|.....|...|...|.....|...|...|.........|.|.|.|.|
|.|||.|||.|||.|||.|||.|||.|.|||.|||||||||||.|.|.|.|
|.|...|.......|.|...|.....|.|...|.|.......|.|...|.|
|.|.||||||#||.|.|||.|||.|||.|||.|.|.|||||.|.|.|||.|
|.|....#|...|.|...|...|...|...|...|.|.....|.|.|...|
|.|.|.##|.|||.|||.|||.|||||||.|||.|.|||.|||.|.|.|||
|.|.|##.|....#..|...|.|..###..|...|...|.....|.|.|.|
|.|.|#..|||||||.|.|.|.|.||#||||.|||||.|||||||.|.|.|
|.|.|#......|...|.|.|...|.....|...|.|.......##|...|
|.|||||||||.|.|||.|||||||.|||||||.|.|||||.|.##|||.|
|.|#......|.|.....|.....|.......|...|...|.|.##..|.|
|.|.|||||.|.|||||||.|.|||.|||||.|||.|.|.|||#|||||.|
|###|.....|.........|.....|##.|.....|.|...|######.|
|.|||.|||||||||||||||||||||#|.|||||||.|||.|#....#.|
|...|.................######|##.........|....##...|
|||||||||||||||||||||||||||||||||||||||||||||||||||